aakkonen	n	alfabehta
aallonpituus	n	bárroguhkkodat
aalto	n	bárru
aarre	n	dávvir
aate	n	idea, jurdda
aatelinen	a	ádelii gullevaš
aatteellinen	a	ideálaš, jurddalaš
aavikko	n	sáttoáhpi
aavistaa	v	ávaštit
absoluuttinen	a	absoluhta, absoluhtalaš
absorboida	v	absorberet
absurdi	a	absurda
afrikkalainen	a	afrihkkálaš
afroamerikkalainen	a	afroamerihkalaš
agentti	n	ageanta
aggressiivinen	a	aggressiiva
ahdistella	v	doarrádallat
aho	n	gieddi
aiempi	a	ovddit
aihe	n	fáddá
aiheuttaa	v	dagahit
aiheutua	v	leat sivvan, čuožžilit
aika	a	viehka
aika	n	áigi
aikaansaada	v	oažžut áigái
aikainen	a	-áigásaš
aikakausi	n	áigodat
aikalainen	a	áigeguoibmi
aina	adv	álo
aineisto	n	ávdnasat, materiála
aines	n	materiála
ainutlaatuinen	a	earenoamáš
aisti	n	áicu
aistia	v	áicat
aito	a	eakti
aivot	npl	vuoigŋašat
ajaa	v	vuodjit
ajankohta	n	muddu
ajanmukainen	a	áigáiheivvolaš
ajatella	v	jurddašit
ajattaa	v	vuojihit
ajattelu	n	jurddašeapmi
ajelehtia	v	rievdat
ajo	n	sáhttu
ajoneuvo	n	fievru
akatemia	n	akademiija
aktiivi	a	aktiiva, aktiivvalaš
aktivoida	v	aktiveret
ala	a	vuolle-
ala	n	viidodat, suorgi
alaisuus	n	vuollai
alamainen	a	riikkavuloš
alanko	n	vuolládat
alapuoli	n	vuolábealli
alava	a	vuollegaš
alentua	v	vuollánit
aleta	v	vuollánit
ali	po	vuoli
alistaa	v	soardit
alitse	po	vuoli
alittaa	v	čákŋat vuoli
alkaa	v	álgit
alkio	n	álgu, čuolbma, áhta
alku	n	álgu
alkuaine	n	álgoávnnas
alkuperä	n	boahtimuš
alkuperäinen	a	álgoálgosaš
alkupuoli	n	álgogeahči
alkuvaihe	n	álgu, álgomuddu
alkuvuosi	n	álgojahki
allekirjoittaa	v	vuolláičállit
aloittaa	v	álggahit
altis	a	soddjil
alunen	n	vuoláš
alus	n	fanas
alusta	n	vuoláš, juolgi
alustaa	v	álggahit
alustava	a	álgo-
amerikkalainen	a	amerihkálaš
ammatti	n	ámmát
ammattikorkeakoulu	n	fidnoallaskuvla
ammattimainen	a	ámmátlaš
ammentaa	v	goaivvut
ammolleen	adv	caggos
ammus	n	báža
ampua	v	bahčit
analoginen	a	analogalaš
analysoida	v	analyseret
analyyttinen	a	analyhtalaš
anastaa	v	suoládit
ankka	n	suorsá
anne	n	atta
ansio	n	ánsu
antaa	v	addit
antautua	v	vuollánit
arabi	n	arába
arabialainen	a	arábalaš
aramealainen	a	aramealaš
arka	a	árgi
arkinen	a	árga-
arkki	n	árka
arkkipiispa	n	earkebisma
armas	a	gieris
armeija	n	arméa
arpoa	v	vuorbádit
arvella	v	árvalit
arvio	n	árvu, sulla
arvo	n	árvu
arvostaa	v	atnit árvvus
arvostella	v	árvvoštallat
arvostus	n	árvu
ase	n	vearju
aseellinen	a	vearjo-
aseistaa	v	verjet
asentaa	v	bidjat sadjái
asento	n	stellelmas
asettaa	v	ásahit
asettua	v	ássat, sajáiduvvat
asia	a	ášši
asianmukainen	a	áššáigullevaš
asianosainen	a	áššáiosolaš
asua	v	orrot, ássat
asukas	n	orru, ášši
asuttaa	v	álggahit orruma
asutus	n	orrun, áššán
aueta	v	rahpasit
aukea	a	rabas
aukio	n	šillju, jalgadas
aukko	n	ráigi
aulis	a	dáhtolaš
aurinko	n	beaivváš
aurinkoinen	a	beaivvádat-
aurinkokunta	n	beaivvášgoddi
autonominen	a	autonoma
auttaa	v	veahkehit
avaruus	n	gomuvuohta
avata	v	rahpat
avioitua	v	náitalit
avustaa	v	veahkehit
avustaja	n	veahkki
avustus	n	doarjja
bakteeri	n	bakteara
baletti	n	baleahtta
data	n	dáhta, addagat
dramaattinen	a	dramáhtalaš
dynaaminen	a	dynámalaš
edellyttää	v	gáibidit
edellytys	n	gáibadus
edeltä	po	ovddal
edeltäjä	n	ovddasmanni
edeltää	v	mannat ovddas
edetä	v	ovdánit
edistyksellinen	a	progressiiva
edistyä	v	ovdánit
edistää	v	ovddidit
editse	po	ovddabeale
edullinen	a	govttolaš, ovddolaš
eduskunta	n	riikkabeaivvit
edusta	n	ovda
edustaa	v	ovddastit
edustava	a	ovddasteaddji
edustus	n	ovddasteapmi
eeppinen	a	epihkalaš
eettinen	a	etihkalaš
egyptiläinen	a	egyptalaš
ehjä	a	čavddis
ehkäistä	v	eastadit
ehto	a	eaktu
ehtoollinen	n	eahkedaččat
ehtyä	v	sadjanit
ei	v	ii
eikä	cc	iige
ekologinen	a	ekologalaš
eksoottinen	a	eksotihkalaš
elektroninen	a	elektronalaš
elementti	n	elemeanta
eli	cc	dahje
elikkä	cc	dahjege
eliminoida	v	elimineret, sihkkut
elimistö	n	organisma
elin	n	orgána
elinaika	n	eallinahki
elinikäinen	a	agibeai-
elinkautinen	a	agibeaivvi
elintarvike	n	borramušgálvu
elinympäristö	n	eallinbiras
eliö	n	organisma
ellen	cs	juos in
elliptinen	a	ellipttalaš
elo	n	eallu
eloisa	a	ealaskas
elokuva	n	ealligovva, filbma
elpyä	v	ealáskit
elämä	n	eallin
elämäkerta	n	biografiija
elävä	a	ealli
elää	v	eallit
emo	n	eadni
englanti	n	eŋgelasgiella
englantilainen	a	eŋgelas, englándalaš
enin	a	eanemus
enkä	cc	inge
ennakoida	v	ávaštallat, noahkut
ennustaa	v	einnostit
ensi-ilta	n	vuosttášeahket, premieara
ensisijainen	a	vuosttaš
entistää	v	ovddeštit, restaureret
entisöidä	v	ovddeštit, restaureret
entää	v	šat eambbo
epä	a	eahpe-
epäedullinen	a	vuoittoheapme
epäilevä	a	eahpideaddji
epäillä	v	eahpidit, gáddit
epäinhimillinen	a	olmmošmeahttun
epäluotettava	a	oskkáldasmeahttun
epämääräinen	a	mearritmeahttun
epänormaali	a	eahpenormála
epäonnistua	v	eahpelihkostuvvat
epäpätevä	a	dohkkemeahttun, eahpedohkálaš
epäröidä	v	eahpidit
epätasainen	a	rámššas, dássitmeahttun
epätavallinen	a	eahpedábálaš
epätodennäköinen	a	eahpejáhkehahtti
epävakaa	a	stáđismeahttun
epävirallinen	a	eahpevirggálaš
eri	a	eará
erikoistua	v	spesialiseret
erikokoinen	a	mearkkalaš, earenoamáš
erillinen	a	sierra
erimielisyys	n	sierramielalašvuohta
eristäytynyt	a	sierranas
eristäytyä	v	sierranit
eritellä	v	čuolddašit
erittyä	v	vuohčut
eritä	v	sierranit
erivärinen	a	earáivnnat
eriytyä	v	sierranit
erkaantua	v	ravgat
eroottinen	a	erohtalaš, erotihkalaš
erota	v	earránit
erotella	v	erohallat
erottaa	v	earuhit
erottua	v	earránit
erä	n	earri
eräänlainen	a	muhtinlágan
esi	a	ovda
esi-isä	n	máttar
esiintyä	v	gávdnot
esikuva	n	ovdagovva
esitellä	v	čájáhallat
esittää	v	ovddidit
espanjalainen	a	espánjalaš
esteettinen	a	estehtalaš
estää	v	caggat, hehttet
etelä	a	lulli, máddi
eteläinen	a	lulli-, mátta-
eteläpuoli	n	lulábeale, máttabeale
eteneminen	n	ovdáneapmi
etsivä	a	ohcci
etsiä	v	ohcat
etu	n	ovdu, ávki
etäinen	a	gáiddus
etäisyys	n	gaska, mátkegaska
evakuoida	v	evakueret, gurret
evankelinen	a	evangelalaš
eversti	n	obersta
fasistinen	a	fašisttalaš
feministinen	a	feministtalaš
fiktiivinen	a	fiktiiva
filmata	v	filbmet
filosofi	n	filosofa
filosofia	n	filosofiija
filosofinen	a	filosofalaš
funktio	n	funkšuvdna
fysiikka	n	fysihkka
fyysinen	a	fysihkalaš
geologinen	a	geologalaš
geometrinen	a	geometralaš
germaaninen	a	germánalaš
globaali	a	globála
graafinen	a	gráfalaš
haara	n	suorgi, suorri, oaksi
haastaa	v	hástit
haastatella	v	jearahallat
haavoittua	v	hávvádit
hahmo	n	figuvra, hápmi
hahmotella	v	hámuhit
haihtua	v	hevrriidit
haihtuva	a	hohpi
haitata	v	hehttet
haittaava	a	hehttejeaddji
hajaantua	v	bieđganit
hajalle	adv	hájilassii
hajanainen	a	bieđggus
hajauttaa	v	biđggiidahttit
hajota	v	bieđganit
hajottaa	v	biđget
hakeutua	v	áigut, ohcalit
haljeta	v	luoddanit
halkoa	v	luoddut
hallita	v	hálddašit
hallitus	n	ráđđehus
hallussa	adv	hálddus
halpa	a	hálbi
haltija	n	eaiggát
haltuun	po	háldui
halukas	a	dáhtolaš
haluta	v	háliidit
halvaantua	v	gáldnat
halventaa	v	hálbut
hanke	n	fidnu
hankkia	v	háhkat, skáhppot
hapettaa	v	oksyderet
happi	n	oksygena
harhaanjohtava	a	čádjidahtti
harhauttaa	v	čádjidahttit
harjata	v	gustet
harjoittelu	n	hárjehallan
harkita	v	árvvoštallat
harmaa	a	ránis
harmaanruskea	a	ránesruškat
harmoninen	a	harmonalaš
harras	a	duođalaš, áŋgir
harrastaa	v	buđaldit
harva	a	hárvi
harvalukuinen	a	vuorji
harvinainen	a	hárvenaš
hauras	a	rašši
hautajaiset	npl	hávdádeapmi
hautoa	v	hávdut
havainto	n	áicu, fuomášupmi
havaita	v	áicat, fuobmát
havitella	v	háhpohallat
hedelmällinen	a	šattolaš
hedelmöittää	v	sahkanahttit
hehkuva	a	áhcagas
heijastaa	v	speadjalastit
heijastua	v	speadjalastit
heikentyä	v	hedjonit
heikentää	v	heajudit
heikko	a	headju
heiluttaa	v	šlivgut
heimo	n	čearda
heinä	n	suoidni
heittää	v	bálkestit
helpottaa	v	álkidahttit
helppo	a	álki
henki	n	heagga, vuoigŋa
henkilö	n	olmmoš, persovdna
henkilökohtainen	a	persovnnalaš
henkilökunta	n	bargoveahka
henkiä	v	čohkut
heprea	n	hebreagiella
herättää	v	boktit, rávkat
herätä	v	gohccát
hetki	n	boddu
hetkinen	a	bottaš
hiekka	n	sáttu
hienojakoinen	a	
hiili	n	hilla, čađđa
hiilidioksidi	n	kárbondioksiida
hiippakunta	n	bismagoddi
hillitä	v	doalahallat
hinata	v	geasehit
hioa	v	sadjit, šliipet
hirttää	v	harcet
hirviö	n	boragas
historioitsija	n	historjáčálli
hiukkanen	n	čalbmi
hohtaa	v	šlietnjat
hoikka	a	seaggi
hoitaa	v	dikšut
homoseksuaalinen	a	homoseksuála
hopeinen	a	silba-
horjuttaa	v	suoibbuhit
houkutella	v	hohkahallat, geasuhit
huhuta	v	beakkohit
huima	a	vilddas
huippu	n	čohkka, boldni
hukata	v	láhppit
hukuttaa	v	heavahit, láhppit
humanistinen	a	humanisttalaš
huolestua	v	fuolastuvvat
huolestuttaa	v	fuolasuhttit
huoli	n	fuolla, moraš
huolia	v	fuollat
huoltaa	v	dikšut, fuolahit
huomata	v	fuobmát, fuomášit
huomattava	a	mearkkašahtti
huomio	n	áican
huomioida	v	fuomášit
huomionarvoinen	a	fuomášanveara
huonokuntoinen	a	silli
huonontaa	v	heajudit
huonontua	v	hedjonit
huonota	v	hedjonit
hupa	a	hohppil
hurja	a	vilddas
huumori	n	humor
huveta	v	skollat
hylky	a	vudjon fanas
hylätä	v	hilgut
hyvä	a	buorre
hyväksyttävä	a	dohkálaš
hyväksyä	v	dohkkehit
hyväkuntoinen	a	sávri
hyödyntää	v	atnit ávkin
hyökkääjä	n	falleheaddji
hyökkäävä	a	vuovdnái
hyökätä	v	rohkkáhit
hyötyä	v	ávkašuvvat
häipyä	v	jávkat
häiritsevä	a	unohas
häiritä	v	heađuštit
hälyttää	v	alarmeret
hämmästyttää	v	imaštuhttit
hämmästyä	v	imaštuvvat
hämärä	a	veaigi
hämätä	v	dájuhit
hävittää	v	duššadit
hävitä	v	dáhpet
häät	npl	heajat
idealistinen	a	idealisttalaš
identifioida	v	identifiseret
identtinen	a	ideanttalaš
ideologi	n	ideologa
ideologia	n	ideologiija
ideologinen	a	ideologalaš
ihailla	v	hervvošit
ihanteellinen	a	optimála
ihastua	v	liikostit
ihastunut	a	ilolaš
ihme	n	imaš
ihminen	n	olmmoš
ihmiskunta	n	olmmošsohka
ikivanha	a	áigahaš
ikivihreä	a	áloruonas
ikuinen	a	agálaš
iljetä	v	storrát
ilkeä	a	árvvoheapme
illallinen	a	eahkedaččat
ilma	n	áibmu
ilmainen	a	nuvttá
ilmaista	v	cealkit
ilmakehä	n	áibmogeardi
ilmeinen	a	čalmmus
ilmentää	v	čájehit
ilmestyä	v	almmustuvvat
ilmiö	n	albmoneapmi, fenomena
ilmoittautua	v	almmuhit iežas
iloinen	a	ilolaš
iltainen	a	eahkedaš
imettää	v	njamahit
inhimillinen	a	olmmošlaš
inhota	v	fasttášit
innokas	a	movttet
innostaa	v	movttiidahttit
innostua	v	movttáskit
insinööri	n	inšenevra
intialainen	a	indialaš
irrallinen	a	bođu-
irrota	v	beassat
irtaantua	v	luovvanit
irtain	a	luovus
irtautua	v	čuoldásit
irti	po	luovus
isku	n	časkkástat
islamilainen	a	islámalaš
islantilainen	a	islándalaš
iso	a	stuorat
isokokoinen	a	goakŋit
istua	v	čohkkát
istuttaa	v	čohkkáhit, bidjat šaddat, gilvit
isä	a	áhčči
isännöidä	v	isidastit
isäntä	n	isit
italialainen	a	italialaš
itsenäistyä	v	šaddat iehčanasásan
itsenäisyys	n	iehčanasvuohta
itä	n	nuorta
itäinen	a	nuorta-
itämainen	a	nuortaeatnanlaš
itämerensuomalainen	a	nuortamearasuopmelaš
itäosa	n	nuortabealli
iätä	v	dateret
jakaa	v	juohkit
jakaantua	v	juohkašuvvat
jakautua	v	juohkašuvvat
jakso	n	ráidu, oassi
jalkapallo	n	spábbačiekčan, čiekčanspábba
jalkaväki	n	juolgeveahka
jalo	a	vuoiggalaš
jalostaa	v	dikšut
jaollinen	a	jugolaš
jaotella	v	juogadit
japanilainen	a	japánalaš
jarruttaa	v	goahcat
jatkaa	v	joatkit
jatko	n	joatkki
jatkua	v	joatkašuvvat
jatkuva	a	bissovaš
joensuu	n	joganjálbmi
johdattaa	v	oahpistit
johdos	n	suorggus
johdosta	po	geažil
johonkin	adv	juosat
johtaa	v	hovdet, jođihit
johtava	a	njunuš
johto	n	njunuš
johtua	v	boahtit, čuovvut
joki	n	johka
jollainen	a	makkár
jolloin	adv	goas
jonkinlainen	a	juogalágan
jonne	adv	gosa
jonnekin	adv	juosat
joskin	cs	juos
jostakin	adv	juoga saje
joten	adv	nu ahte
jotta	cs	ahte
joukko	n	joavku
joukkue	n	lága
jousi	n	dávgi
joustaa	v	dávggastit, guorrat
joustava	a	dávggas
joutua	v	šaddat, gártat
juhla	n	ávvudeapmi, riemut
juhlallinen	a	allaáiggálaš
juhlapäivä	n	illubeaivi
julistaa	v	almmuhit
julkaista	v	almmustahttit
julkaisu	n	publikašuvdna
julkistaa	v	almmustahttit
julma	a	julbmi
jumalainen	a	ipmillaš
jumalallinen	a	ipmila
juoda	v	juhkat
juokseva	a	viehkki
juoksu	n	viehkan
juoni	n	juotna
juonia	v	juonastit
juonitella	v	juonastit
juontaa	v	jođihit
juosta	v	viehkat
juottaa	v	jugahit
juuri	n	ruohtas, veaddi
jylhä	a	rámššas
jyvänen	n	čalbmi
jähmettyä	v	stirdut
jäljitellä	v	áđđestallat
jäljittää	v	vuohttit
jälkeläinen	n	maŋisboahtti
jälki	n	luodda
jälkimmäinen	a	maŋimus
jännite	n	gealdagas
jännittää	v	(jousi) gealdit, gealdašuvvat
järeä	a	šumppas
järjestellä	v	ordnet, lágidit
järjestelmällinen	a	systemáhtalaš
järjestäytyä	v	lihtodaddat
järjestää	v	lágidit, ordnet
järkkyä	v	lihkkasit
järkyttyä	v	soasihit, lihkkasit
järkyttää	v	guoskkahit sakka
jäsenyys	n	lahttuvuohta, miellahttuvuohta
jättäytyä	v	geassádit
jättää	v	guođđit
jää	n	jiekŋa
jäädä	v	báhcit
jäähdyttää	v	čoaskudit
jäähtyä	v	čoaskut
jääkausi	n	jiekŋaáigi
jääkiekko	n	jiekŋaskearru
jäänne	n	bázahas
jäätyä	v	galbmot
jäätön	a	saŋas
jäävi	a	inhabiila
kaakko	n	nuortalulli
kaapata	v	váldit, rivvet
kaartua	v	sodjat gávvat
kaasu	n	gássa
kaasuttaa	v	gásset
kaataa	v	njeaidit
kaatua	v	gahččat
kaava	n	minsttar
kaavailla	v	hivvehallat
kadota	v	jávkat
kadottaa	v	láhppit
kahdenlainen	a	guovttelágan
kaikenlainen	a	juohkelágan
kaikkialla	adv	juohke bealde, miehtá
kaikkialle	adv	juohke beallai, miehtá
kaksikerroksinen	a	guovttegearddaš
kaksinkertainen	a	guovttegeardán
kaksisuuntainen	a	guovtteguvllot
kalju	a	báljis
kallio	n	bákti, gálli
kalteva	a	hálu
kalusto	n	gálvvut
kampa	a	čohkun
kamppailla	v	dáistalit
kamppailu	n	dáistaleapmi
kanavoida	v	kanaliseret
kandidaatti	n	kandidáhta
kannattaja	n	guotteheaddji
kannatus	n	guottehus
kannella	v	guoddalit
kannettava	a	guoddin-
kannustaa	v	arvvosmahttit
kansa	n	álbmot
kansallislaulu	n	nášuvnnalávlla
kansallismielinen	a	nationalisttalaš
kansallistaa	v	nationaliseret
kansanedustaja	n	riikkabeaiveolmmái
kansanomainen	a	álbmotlaš
kansanpuolue	n	álbmotbellodat
kansanäänestys	n	álbmotjienasteapmi
kanta	n	šušmi
kantaa	v	guoddit
kantama	n	-badji
kantatie	n	máttageaidnu
kantava	a	nanus, (eläimistä) čoavje-
kapearaiteinen	a	seakkaluottat
kapellimestari	n	kapeallameašttir
kapi	n	gáittát
kapina	n	stuibmi
kapinallinen	a	stuibmideaddji
kapinallinen	n	gaikár
kapinoida	v	stuibmidit
kapitalistinen	a	kapitalisttalaš
kappa	a	gabba
kappeli	n	kapealla
kappi	a	jocca
karata	v	gárgidit
kardinaali	n	kardinála
kariutua	v	cohkkot
karja	n	eallu, (lehmistä) oamit
karjalainen	a	gárjilaš
karkea	a	roavis
karkottaa	v	ádjit, vuodjelit
karsia	v	njáskat
karsinta	n	njáskan
karsiutua	v	njáskasit
kartano	n	gárdin
karttaa	v	garvit, hilggodit
kartuttaa	v	gártadit, lasihit
karu	a	šattoheapme
kasautua	v	čoggot
kasvaa	v	šaddat
kasvattaa	v	šaddadit
kasvatus	n	(kasvin) šaddadeapmi, (lapsen) bajásgeassin
kasvava	a	šaddi
kasvi	a	šaddu
kasvillisuus	n	šattolašvuohta, vegetašuvdna
kasvitieteellinen	a	šaddodieđalaš, botanihkalaš
kasvu	n	šaddu
katala	a	guoktilaš, behtolaš
katkaista	v	botket
katketa	v	boatkanit
katolilainen	a	katolalaš
katolinen	a	katolalaš
katsoa	v	geahččat
kattaa	v	gokčat
kattava	a	ollislaš, gokči
katuva	a	gáhtavaš
kauhistua	v	soasihit, gáfestuvvat
kaukainen	a	gáiddus
kaunokirjallinen	a	čáppagirjjálaš
kaupankäynti	n	gávpi
kauppa	n	gávpi, rámbuvri
kauppakeskus	n	gávpeguovddáš
kauppala	n	gávpegielda
kaupunginosa	n	gávpotoassi
kaupunginvaltuusto	n	gávpotstivra
kaupunki	n	gávpot
kaupunkilainen	n	gávpotolmmoš
kausi	n	áigodat
kaveta	v	gáržut
kehitellä	v	ovddidit
kehittyminen	n	ovddideapmi
kehittynyt	a	searalaš
kehittyä	v	gárggiidit
kehittää	v	gárget, gárgehit
kehitys	a	gárggiideapmi
kehitysvammainen	a	bázahallan
kehkeytyä	v	šaddat, bohciidit
kehno	a	heittot
kehä	n	biras
keino	n	geaidnu
keinotekoinen	a	dahku-
keisari	n	keaisár
keisarikunta	n	keaisárriika
keksi	n	keaksa
keksijä	n	hutki
keksintö	n	hutkkus
keksiä	v	hutkat
kellertävä	a	fiskeslágan
kellertää	v	fiskát
kelpuuttaa	v	dohkkehit
kemia	n	kemiija
kemiallinen	a	kemiijalaš
kenraali	n	generála
kerros	n	geardi
kertoa	v	muitalit
kertyä	v	čoggot, gártat
keräillä	v	čoaggit
kerätä	v	čoaggit
kerääntyä	v	čoahkkanit
keskelle	po	guovdu
keskeltä	po	guovdu
keskeneräinen	a	gaskan
keskeytyä	v	gaskkalduvvat
keski	a	gaska-
keski-ikäinen	a	gaskaahkásaš
keskiaikainen	a	gaskaáigásaš
keskiarvo	n	gaskaárvu
keskikokoinen	a	gaskamahtosaš
keskimääräinen	a	gaskamearálaš
keskinen	a	gaska-, guovda-
keskinkertainen	a	gaskageardán
keskittyä	v	čoahkkanit, vuodjut
keskittää	v	čohkket
keskus	n	guovddáš
keskusta	a	guovddáš
keskuudessa	po	gaskkas, siste
kestää	v	bistit, gierdat
kesä	n	geassi
ketju	n	gehtegat
keuhko	a	geahpis
keuhkot	npl	geahppát
keveä	a	geahpas
kevyt	a	geahpas
keväinen	a	-giđđasaš
kiduttaa	v	biinnidit
kiehua	v	duoldat
kieli	n	giella, (suussa) njuovčča
kieliopillinen	a	grammatihkalaš
kielioppi	n	giellaoahppa
kielitieteellinen	a	gielladieđalaš
kielletty	a	gielddus
kielteinen	a	gieldi
kieltäytyä	v	biehtadit
kieltää	v	gieldit
kierros	n	jorus
kierto	n	garvin
kiertue	n	gierdomátki
kiertyä	v	giessasit
kiertää	v	johtit birra
kierukka	n	spirála
kietoutua	v	giessasit
kihlata	v	gihládit
kiihdyttää	v	jođálmahttit
kiihottaa	v	giktalit
kiihtyä	v	jođálmuvvat, (suuttua) eaddut, suhttat
kiinalainen	a	kiinnálaš
kiinnittyä	v	giddanit
kiinnittää	v	giddet
kiinnostaa	v	mielaid geassit
kiinnostava	a	beroštahtti
kiinnostua	v	beroštišgoahtit
kiinteä	a	giddat
kiista	n	nággu
kiistellä	v	nákkáhallat, digaštallat
kiivas	a	moarrái
kiivetä	v	goargŋut
kiljua	v	biškut, gilljut
kilo	n	kilo
kilogramma	n	kilográmma
kilpailla	v	gilvvohallat, gilvalit
kimppu	n	gihppu, (kukkia) gihppu
kiristyä	v	čavgat
kiristä	v	šnjirrat
kirja	n	girji
kirjaimisto	n	alfabehta
kirjakieli	n	girjegiella
kirjata	v	registreret
kirjoa	v	hervet, girjjohallat
kirjoittaa	v	čállit
kirjoittaja	n	čálli
kirkko	n	girku
kirkkoherra	n	girkohearrá
kirkolliskokous	n	girkolaščoahkkin
kisa	n	gilvvohallan, gilvu
kiskoa	v	gaikut
kita	n	soalvi
kiteytyä	v	kristalliserejuvvot
kitkeä	v	hilsket
kitua	v	biidnašuvvat
kivi	n	geađgi
kivikausi	n	geađgeáigi
kivinen	a	geađgái
kivuta	v	gakcut
klassikko	n	klassihkar
klassinen	a	klassihkalaš
kliininen	a	klinihkalaš
kohdata	v	deaivat
kohdella	v	gieđahallat
kohden	po	vuollai
kohdistaa	v	čuozihit
kohentaa	v	divodit
kohota	v	allánit
kohottaa	v	bajidit, loktet
kohtalokas	a	várálaš, vuorbbálaš
kohtaus	n	dohppehallan
kohti	po	guovdu
kohtisuora	a	beanta
kohu	n	šlápma
kokea	v	vásihit
kokeellinen	a	eksperimentála
kokenut	a	oahppan
koko	a	oppa
kokoelma	n	čoakkáldat
kokoinen	a	-mahtosaš
kokoonpano	n	čoakkádus
kokoontua	v	čoahkkanit
kolikko	n	šlánta
kolkka	a	mohkki
kollektiivinen	a	kollektiiva
kolmannes	n	goalmmádas
kolmio	n	golbmačiehka
kolmiosainen	a	golmmaoasat
kolmivuotias	a	golmmajahkásaš
kolmivuotinen	a	golmmajahkásaš
komea	a	hámálaš
komedia	n	komediija
komentaa	v	kommanderet
komento	n	kommanderen
komitea	n	komitea
kommentoida	v	kommenteret
kommunikoida	v	kommuniseret
kommunismi	n	kommunisma
kommunisti	n	kommunista
kommunistinen	a	kommunisttalaš
komponentti	n	komponeanta
konflikti	n	konflikta
kongressi	n	kongreassa
konkurssi	n	reastaluvvan, konkursa
kontrolloida	v	kontrolleret
koodi	n	koda
koominen	a	komihkalaš
koordinoida	v	koordineret
koostua	v	čoahkkanit
koota	v	čohkket
kopio	n	kopiija
kopioida	v	mielddustit
korea	a	goarrat
korealainen	a	korealaš
koristeellinen	a	hearvái, čiŋahuvvon
koristella	v	čiŋahit
korjata	v	divvut
korkea	a	allat
korkea-arvoinen	a	allaárvvot
korkeatasoinen	a	alladássásaš
korostaa	v	deattuhit
korottaa	v	bajidit
korvata	v	buhttet
kosia	v	sogŋostallat
koskea	v	guoskat
kosketin	n	čuggenskáhpu
koskettaa	v	guoskkahit
koskinen	a	guoikái
kostaa	v	mávssahit
koti	n	ruoktu
kotikaupunki	n	ruovttugávpot
kotimaa	n	ruovttueanan
kotimainen	a	ruovttueatnamis dahkkon
kotka	n	goaskin
koto	n	ruoktu
kotoinen	a	ruovttulágan
koulu	n	skuvla
koulukunta	n	skuvla
kouluttaa	v	skuvlet
kourallinen	a	čorpma dievva
kovettua	v	garrat
kreikankielinen	a	greikkagielalaš
kreikka	n	greikkagiella
kreikkalainen	a	greikkalaš
kreivi	n	greavva
kriitikko	n	kritihkar
kriittinen	a	kritihkalaš
kritiikki	n	kritihkka
kritisoida	v	kritiseret
krooninen	a	kronalaš
kuiva	a	goikkis
kuivata	v	goiket
kuivua	v	goikat
kukistaa	v	vuoitit, njeaidit
kukistua	v	vuoittahallat
kukka	n	rássi
kukkia	v	lieđđut
kukkula	n	boldni
kuljettaa	v	fievrridit
kuljettaja	n	vuoddji
kuljetus	n	fievrrideapmi
kulkeutua	v	fievrasit
kulku	n	johtu
kulloinenkin	a	guhtege
kulloinkin	adv	goasge
kulmikas	a	máŋggačiegat
kulta	n	golli
kultamitali	n	gollemedállja
kulttuurillinen	a	kultuvrralaš
kulua	v	gollat, nohkat
kulunut	a	gollan
kuluttaa	v	golahit
kuluttaja	n	golaheaddji, geavaheaddji
kumota	v	gomuhit
kuningas	n	gonagas
kuningaskunta	n	gonagasriika
kunnes	cs	dasságo
kunnianhimoinen	a	gudneáŋgir
kunnioittaa	v	gudnejahttit
kunnollinen	a	ávda
kunnostautua	v	goargguhit iežas
kuolema	a	jápmin
kuolettaa	v	jámihit
kuolettava	a	goddi
kuolla	v	jápmit
kuoriutua	v	njaldásit
kuormata	v	lástet
kurkkia	v	guovlladit
kuroa	v	snorrat
kusta	v	gožžat
kustannus	n	goasttádus
kutea	v	gođđat
kutoa	v	gođđit
kutsua	v	bovdet, gohččut
kutsuttaa	v	bovdehit, gohčodit
kuu	n	mánnu
kuukausittainen	a	mánnosaččat
kuulla	v	gullat
kuulostaa	v	čuodjat, gullot
kuultaa	v	čuovgat
kuulua	v	gullot
kuumeta	v	báhkkanit
kuuro	a	bealjeheapme
kuuro	n	oakti
kuvaava	a	govvideaddji
kuvailla	v	govvidit
kuvastaa	v	speadjalastit
kuvata	v	govvidit, govvet
kuvaus	n	govvádus
kuvio	n	govadat
kuvitella	v	govahallat
kuvittaa	v	illustreret, govuhit
kuvitteellinen	a	govahallon
kyetä	v	bastit, nákcet
kylki	n	gilga, siidu
kyllästyä	v	dolkat
kylmätä	v	galmmistit
kylvää	v	gilvit
kyläläinen	a	gillilaš
kypsä	a	givssas
kyse	n	jearaldat
kyseenalainen	a	jearaldatvuloš
kyseinen	a	guoskevaš
kysyntä	n	jearaldat
kytkeytyä	v	laktásit
kytkeä	v	laktit, čatnat
kyvykäs	a	searra
kärsiä	v	gillát
käsi	n	giehta
käsikirjoittaa	v	
käsikirjoittaja	n	
käsissä	po	
käsitellä	v	gieđahallat
käsittää	v	ipmirdit, áddet
käsitys	n	ipmárdus, áddejupmi
kätevä	a	anolaš
kätkeä	v	čiehkat
käydä	v	geavvat, mannat
käynnistyä	v	johtui boahtit
käynti	n	fitnan, galledeapmi
käyrä	a	gavvar
käyrä	n	sodju, moalki
käytettävä	a	atnámuš
käyttäminen	n	geavaheapmi
käyttäytyä	v	meannudit
käyttää	v	geavahit
käyttö	n	atnu
käyttöjärjestelmä	n	geavahanvuogádat
käyttökelpoinen	a	anolaš
käyttötarkoitus	n	geavahanulbmil
käännyttää	v	jorgalahttit
käänteinen	a	jorggu-
kääntyä	v	jorggihit, jorgalit
kääntää	v	jorgalit
kääpiö	n	dorri
laaja	a	viiddis
laajentaa	v	viiddidit
laajentua	v	viidut
laajeta	v	viidut
laajuus	n	viidodat
laakea	a	duolbbas
laantua	v	váidut
laatia	v	gárvvistit
ladata	v	láddet
lahjoa	v	vuoidat
lahko	n	sierrasearvi
lahti	n	luokta
laiduntaa	v	guođohit
laillistaa	v	dahkat lágalažžan
laimeta	v	láivut
lainsäädäntö	n	láhkaásaheapmi
laite	n	apparáhta, bierggas, rusttet
laittaa	v	bidjat, stellet
laiva	n	fanas
laivasto	n	suvddus
laivata	v	suvddihit
laki	n	láhka
lakkauttaa	v	heaittihit
lama	n	deprešuvdna
lamauttaa	v	dárpmehuhttit
langeta	v	ravgat, gahččat
langettaa	v	ravggahit
lapa	n	láhpi, (airon) speađđu
lappaa	v	duohpat
lappalainen	a	sápmelaš
lappi	n	sápmi
lapsi	n	mánná
laskea	v	luoitit
laskettaa	v	čierastit
laskeutua	v	luoitalit
lasta	n	stielku
latina	n	latiinnagiella
latinalainen	a	latiinnalaš
laueta	v	báhccat
lauhkea	a	liehmus
laukaista	v	báhcahit
laukaus	n	skuohtta
laukkoa	v	ruohttat
laukoa	v	báhcahallat
laulaa	v	lávlut
lauma	n	valvi
lausua	v	cealkit
lavastaa	v	lágidit lávddi
lehti	n	lasta, áviisa
lehtinen	n	gihpa
leijua	v	sattáhallat
leikata	v	čuohppat
leikkaus	n	čuohpadus
lempi	n	ráhkisvuohta
lempinimi	n	jiellahastalannamma
lennättää	v	girddihit
lento	n	girdin
lentoasema	n	girdišillju, girdihámman
lentää	v	girdit
levittäytyä	v	leavvat
levittää	v	lebbet, viiddidit
levitä	v	leavvat
levottomuus	n	dilihisvuohta, leabohisvuohta
levy	n	duolbbus, pláhta
levyinen	a	govdosaš
levyttää	v	ráhkadit skearru
liberaali	n	liberála
liekehtiä	v	njuoršut
lietsoa	v	fáddet
lieventää	v	litnudit
lievittää	v	geahpidit, álkidahttit
liha	a	biergu
liike	n	(liikunta) lihkadus, (yritys) fitnodat
liikemies	n	fitnodatolmmái
liikenne	n	johtalus, johtolat
liikennöidä	v	johtalit
liiketoiminta	n	fitnodatdoaibman
liikevaihto	n	vuovdimat
liikkua	v	lihkadit, lihkkat
liikkuva	a	johtti
liikuttaa	v	lihkahit
liimata	v	liibmet
liioitella	v	stuorádallat
liitto	n	lihttu
liittoutua	v	lihtodit
liittovaltio	n	
liittymä	n	geaidnolakta
liittyä	v	láktasit
liittää	v	laktit
liitää	v	seivvodit, sattihit
liki	po	lahka
linnoitus	n	ladni
lisenssi	n	liseansa
lisä	n	lassi
lisäksi	po	lassin
lisätä	v	lasihit
lisääntyminen	n	lassáneapmi
lisääntyä	v	lassánit
liueta	v	luvvat
liukua	v	johtit
logiikka	n	logihkka
lohi	n	luossa
lohikäärme	n	guovdi
lohko	n	laiggus
lohkoa	v	laigut
loikata	v	čellet, hárčet
loiva	a	njoaiddus
looginen	a	logalaš
lopettaa	v	heaitit
loppu	n	loahppa
loppua	v	nohkat
loppupuoli	n	loahpageahči
lopputulos	n	loahppaboađus
louhia	v	boltut
loukata	v	norddastit, lábmet
loukkaantua	v	lápmašuvvat
lounainen	a	oarjelulli
lounas	n	lunša, beaivemális
luennoida	v	logaldallat
luetella	v	logahallat
luettaa	v	logahit
luettava	a	logus
luetteloida	v	bidjat lohkui
luhistua	v	gahččat
lujittaa	v	nannet
lukea	v	lohkat
lukeutua	v	lohket iežas (+ill)
luku	n	lohku
lukuisa	a	eatnatlohkosaš
lukumäärä	n	lohku, lohkomearri
luminen	a	muohta-
luo	po	lusa
luoda	v	luovvat
luode	n	oarjedavvi
luoja	n	sivdnideaddji, luovvi
luokitella	v	klassifiseret
luokittelu	n	klassifiseren
luola	n	biedju
luonne	n	luondu
luonnehtia	v	karakteriseret
luonnontiede	n	luonddudieđa, biologiija
luonnontieteellinen	a	luonddudieđalaš, biologalaš
luonnontilainen	a	luonddudilálaš
luonnonvara	n	luondduriggodat
luonnonvarainen	a	luonddusealli
luontainen	a	iežaddiluvvon, lunddolaš
luonteenomainen	a	lunddolaš
luonteva	a	lunddolaš
luonto	n	luondu
luopua	v	luohpat
luoteinen	a	oarjedavvi
luova	a	kreatiiva
luova	n	luovvi
luovuttaa	v	luobahit
lupautua	v	lohpidit iežas
luulla	v	gáddit
lyhentyä	v	oatnut
lyhentää	v	oanidit
lyhytikäinen	a	agiheapme
lyyrinen	a	lyralaš
lähde	n	ája
lähdekoodi	n	gáldokoda
läheisyys	n	lagasvuohta
lähestyä	v	lahkonit
lähetti	n	gohčostat
lähettää	v	sáddet
lähetä	v	lahkonit
lähi	a	lagas-
lähistö	n	lahkosat
lähteä	v	vuolgit
lähtien	po	rájes
lähtö	n	vuolgga
lähtöisin	po	eret
lähtökohta	n	vuolggasadji
lämmetä	v	liegganit
lämmin	a	liekkas
lämmittää	v	ligget
lämmitä	v	liegganit
lämpö	n	liekkas
lämpötila	n	temperatuvra
länsi	n	oarji
länsimaa	n	oarjeriika
länsimainen	a	oarjeriikkaid
länsipuoli	n	oarjjabeale
läntinen	a	oarje-
läpi	n	ráigi
läpäistä	v	čađahit
lävitse	po	čađa
lääke	n	dálkkas
lääketiede	n	dálkkasdieđa
lääketieteellinen	a	dálkkasdieđalaš, medisiinnalaš
löyhä	a	loažžat
löysä	a	loažžat
löytää	v	gávdnat
löytö	n	gávnnus
maa	n	eanan, riika
maaginen	a	magihkalaš
maailma	n	máilbmi
maailmanennätys	n	máilmmioláhus
maailmankaikkeus	n	máilmmiávus
maailmanlaajuinen	a	máilmmiviidosaš
maakunnallinen	a	eanangottálaš
maakunta	n	eanangoddi
maalaiskunta	n	dálongielda
maalata	v	málet
maalaus	n	málen, málagovva
maanalainen	a	eatnanvuloš
maanjäristys	n	eatnandoarggáštus
maanmies	n	riikkaguoibmi
maanpako	n	eananbáhtarus
maanpinta	n	eanangiera
maanpäällinen	a	eatnanlaš
maantie	n	eatnangeaidnu
maantiede	n	eatnandieđa, geografiija
maaottelu	n	riikkagilvu, eanangilvu
maapallo	n	eananspábba
maaperä	n	eananvuođđu
maaseutu	n	dálonguovlu
maatila	n	eanandállu
maattaa	v	eatnamastit
magneetti	n	magnehta
magneettinen	a	magnehtalaš
mahdollistaa	v	dahkat vejolažžan
mahtava	a	fámolaš
maineikas	a	beakkálmas, beakkán
mainen	a	-lágán
maininta	n	máinnašupmi
mainita	v	máinnašit
mainittava	a	máinnašan
mainos	n	rekláma
mainostaa	v	reklameret, rábmot
maisema	n	eatnamat, oainnus
maistaa	v	máistit
maisteri	n	magisttar
majakka	n	čuovgatoardna
majoittaa	v	addit orohaga
maksa	n	vuoivvas
maksaa	v	máksit
maksettava	a	máksámuš
mallinen	a	-mállet
maltillinen	a	loavdi
maltillinen	n	moderáhta
manner	n	nannán
mannermainen	a	nannáma
markkina	n	márkan
marssi	n	mársa
marssia	v	márset, márseret
masennus	n	nuonddahallan, šlundun
massa	n	mássá
matemaatikko	n	matematihkar
matemaattinen	a	matematihkalaš
matkailu	n	mátkkošteapmi
matkustaa	v	mátkkoštit
matkustella	v	jođašit, mátkkoštit
mekaaninen	a	mekanihkalaš, mekánalaš
melkoinen	a	oalle
mellakoida	v	stuibmidit
meneillä	adv	jođus
menestyksekäs	a	menestuvvi
menestys	n	menestupmi
menestyä	v	menestuvvat
menetellä	v	láhttet, meannudit
menetys	n	massin
menneisyys	n	mannanáigi
mennessä	po	rádjái
mennä	v	mannat
meno	n	mannu
merenpinta	n	mearragiera
meri	n	mearra
merkitsevä	a	deaŧalaš, dehálaš
merkitty	a	mearka-
merkittävä	a	fuopmášahtti
merkityksetön	a	mearkkašmeahttun
merkitä	v	merket
messu	n	meassu
mestaruus	n	meašttirvuohta
metalli	n	metálla
metallinen	a	metálla-
metsä	a	meahcci
metsästys	n	bivdu
metsästää	v	meahcástit
miehinen	a	olmmái
miehistö	n	veahka
miehittää	v	okkuperet
miehitys	n	háldui váldin
mielekäs	a	jierpmálaš, govttolaš
mielivaltainen	a	mielaevttolaš
mieliä	v	milohallat
miellyttävä	a	hávski
miellyttää	v	leat miela mielde
mieltyä	v	liikostit
mieluisa	a	mielamiel-
mies	a	olmmái
miespuolinen	a	olmmái
miettiä	v	jurddašaddat
mikäli	cs	juos
millimetri	n	millimehter
milloin	adv	goas
minne	adv	gosa
mistä	adv	gokko
mitali	n	medálja
mitata	v	mihtidit
mitta	n	mihttu
mittakaava	n	mihttolávva, skálá
mittaus	n	mihtideapmi
mittava	a	viiddis
mitätöidä	v	fámohuhtton
mitätön	a	fámoheapme
moinen	a	dakkár
molekyyli	n	molekyla
monimutkainen	a	mohkkái, mohkkát
moninainen	a	máŋggalágán
moninkertainen	a	máŋggageardásaš
monivuotinen	a	máŋggajahkásaš
moottori	n	mohtor
moottoritie	n	mohtorgeaidnu
moraalinen	a	morálalaš
muassa	po	mielde, fárus
muistaa	v	muitit
muistella	v	muitášit
muistelma	n	eallinmuitalus
muisto	n	muitu
muistomerkki	n	muitomearka
muistua	v	máhccat millii
mukautua	v	vuogáiduvvat
mullistaa	v	moivet, borvet vuđolaččat
mullistava	a	jorgalusdahkki
munata	v	čurbošit
muodostaa	v	ráhkadit, čohkket, cegget
muodostua	v	čohkiidit
muokata	v	duddjot
muoto	n	hápmi
muotoilla	v	hábmet
muotoinen	a	-hámat
muotoutua	v	hápmašuvvat
muovata	v	hábmet
muovi	n	plastihkka
muovinen	a	plásttat-
murha	n	olmmošgoddin
murhata	v	goddit
murskata	v	mollet, skálmmastit
murtaa	v	cuvget
murtua	v	doddjot
musiikki	n	musihkka
musta	a	čáhppat
mustasukkainen	a	balahahkes
mustavalkoinen	a	čáhppesvielgat
mutkikas	a	mohkkái
mutta	cc	muhto
muualla	adv	eará sajis
muukalainen	a	vierroolmmoš
muunlainen	a	earálágán
muunnella	v	nuppástuddat
muunnelma	n	rievdadus
muunnos	n	nuppástus
muuntua	v	jorrat
muurata	v	muvret
muuri	n	muvra
muuttaa	v	nuppástuhttit
muutto	n	johtin
muuttua	v	nuppástuvvat
muuttuja	n	variábel
muuttuva	a	rievdil
mystinen	a	mystihkalaš
mytologi	n	mytologa
mytologia	n	mytologiija
myydä	v	vuovdit
myytti	n	myhta
myöhä	a	maŋŋit
myöhäinen	a	maŋŋit
myönteinen	a	positiiva, miehtemielalaš
myöntää	v	mieđihit
myötä	po	mielde
myötäillä	v	sojadit
määritellä	v	meroštallat
määrittää	v	dovdát
määrä	n	mearri
määrätä	v	mearridit
määräytyä	v	čuožžut
naamioida	v	másket, maskeret
naapuri	n	kránnjá
naida	v	váldit beallelažžan, anašit
nainen	a	nisson
naispuolinen	a	nisson-
napa	n	(ihmisen) náhpi, (maant.) povla
nauhoittaa	v	báddet
nelinkertainen	a	njealjegeardásaš
neliö	n	njealjehas
neliökilometri	n	njealjehaskilomehtar
nerokas	a	geniála
neste	n	golggus
neuvoa	v	neavvut
neuvoa-antava	a	ráđđeaddi
neuvosto	n	ráđđi
neuvostoliittolainen	a	sovjetlihttulaš
neuvostotasavalta	n	Sovjetrepublihkka
neuvotella	v	ráđđádallat
neva	a	jeaggi
niemi	n	njárga
niemimaa	n	njárga
nimekäs	a	beakkán
nimellinen	a	nominála
nimetä	v	namahit
nimi	n	namma
nimipäivä	n	nammabeaivi
nimittää	v	namahit
nisäkäs	n	njiččehas
niveljalkainen	a	lađasjuolggat
noita	n	noaidi
nojata	v	mieigat
noki	n	giehpa
nokka	n	geahči
nopea	a	johtil
nopeuttaa	v	jođálmahttit
nopeutua	v	jođálmit
nostaa	v	loktet
nostattaa	v	čuoččáldahttit
noudattaa	v	čuovvut
nousta	v	loktanit
nousu	n	loktaneapmi
noutaa	v	viežžat
novelli	n	novealla
nujertaa	v	soardit
nukkua	v	oađđit
numeroida	v	nummirastit
nykyaika	n	dálá áigi
nykyinen	a	dáláš
nykypäivä	n	otná beaivi
näennäinen	a	gáddojuvvon
nähdä	v	oaidnit
nähtävyys	n	oaidnámuš
nähtävä	a	oaidnámuš
näkemys	n	oaidnu
näkemä	n	álgočalbmái
näkevä	a	oaidni
näky	n	oainnáhus
näkyville	po	oidnosii
näkyvistä	po	oidnosis
näkyä	v	oidnot
näkö	a	oaidnu
näköinen	a	hápmásaš
näytellä	v	čájáhallat
näyttävä	a	čájeheaddji
näyttää	v	čájehit
näyttö	n	čájáhus
nöyryyttää	v	vuolidit
objektiivinen	a	objektiivvalaš
odottaa	v	vuorddihit
oheen	po	oktii
oheinen	a	mielčuovvu
ohella	po	ovttas
ohessa	po	mielde
oheta	v	asehuvvat
ohitse	po	meaddel
ohittaa	v	mannat
ohjailla	v	jođáhallat
ohjata	v	stivret, bagadallat
ohjelmisto	n	prográmmat
ohjelmoida	v	programmeret
ohjus	n	rakeahtta
oieta	v	njuolgat
oikaista	v	njulget
oikea	a	rivttes
oikeanpuoleinen	a	olgeš beale
oikeaoppinen	a	rivttesoahpalaš
oikeistolainen	a	olgešbealeolmmoš
oikeudellinen	a	vuoigatvuođalaš
oikeudenkäynti	n	diggi
oikeudenmukainen	a	vuoiggalaš
oikeus	n	riekti
oikeustieteellinen	a	vuoigatvuođadieđalaš
oikeuttaa	v	vuoigadahttit
oire	n	dávdamearka
oiva	a	alma buorre
oivaltaa	v	fuomášit
oleellinen	a	deaŧalaš, guovddáš-
olemassaolo	n	leahkin, eksisteansa
olemus	n	hápmi
olennainen	a	deaŧalaš
olento	n	orut
oleskella	v	orodit
olettaa	v	navdit
olio	n	orut
olla	v	leat
olo	n	orrun
olosuhde	n	dilli
olympiakulta	n	olympiagolli
olympialaiset	npl	olympiagilvvut
oma	a	oapmi
omaksua	v	oamastit
omalaatuinen	a	iešlágálaš
omaperäinen	a	originála
omata	v	atnit
ominainen	a	mihtilmas
omintakeinen	a	iešlágálaš
omistaa	v	oamastit
omistautua	v	oamastit iežas
omituinen	a	ártet
ongelmallinen	a	problemáhtalaš
onnistua	v	lihkostuvvat
opastaa	v	oahpistit
opinto	n	lohkan
opiskelija	n	studeanta, oahppi
opiskelu	n	studeren, lohkan
oppi	n	oahppa
oppia	v	oahppat
oppilaitos	n	oahppolágádus
oppositio	n	vuostebealli, opposišuvdna
optinen	a	optihkalaš
orgaaninen	a	orgánalaš
organisaatio	n	organisašuvdna
organisoida	v	organiseret
orkesteri	n	orkeasttar
ortodoksinen	a	ortodoksa
osa	n	oassi
osaava	a	čeahppi
osake	n	oasus
osakeyhtiö	n	oasussearvi
osallistua	v	oassálastit
osapuoli	n	oassebealli
osata	v	máhttit
osavaltio	n	oassestáhta
osittainen	a	oasse-
osoittaa	v	čujuhit
osoittautua	v	čájehit iežas
ostaa	v	oastit
osua	v	deaivat
osuus	n	ossodat, oassi
otaksua	v	navdit
otella	v	gilvalit
otollinen	a	heivvolaš
ottaa	v	váldit
ottava	a	čađahit
ottelu	n	gilvu
otto	n	váldin
paavi	n	poava
paha	a	bahá
pahamaineinen	a	bahábeakkálmas
paheksua	v	fasttášit
pahentaa	v	heajudit
paheta	v	bahonit
pahoinpidellä	v	illastit
paikalla	adv	báiki alde
paikallistaa	v	lokaliseret
painaa	v	deaddit
paino	n	deaddu
painopiste	n	deaddočuokkis
painos	n	prentehus
painostaa	v	áŧestit, deaddit
painottua	v	deattuhit
painua	v	deddot
paisua	v	báisat
pakanallinen	a	báhkinlaš
pako	n	báhtareapmi
paksuinen	a	assosaš
pala	n	bihttá
palaa	v	buollit
palata	v	máhccat
palatsi	n	šloahtta
palauttaa	v	máhcahit
palautua	v	máhccat
paljastaa	v	almmustahttit
paljastua	v	báljagit
paljo	a	eatnat
palkkio	n	máksu, bálkkašupmi
pallo	n	spábba
pallonpuolisko	n	jorbálasbealli
palo	n	buollin
paluu	n	máhccan
palvella	v	bálvalit
palvelus	n	bálvalus
panssari	n	pánsár
panssarivaunu	n	pánssárvuovdna
papisto	n	báhppagoddi
parantaa	v	buoridit
parantaminen	n	buorránmeahttun
parantua	v	buorránit
paras	a	buoremus
parhain	a	buoremus
pari	n	bárra
paritella	v	kopuleret
parka	a	riehpu
partio	a	patrulla
partioida	v	patrulleret
passiivinen	a	passiiva
patentoida	v	patenteret
patentti	n	pateanta
patsas	n	bázzi
peittää	v	gokčat
pelaaja	n	spealli
pelastaa	v	gádjut
pelata	v	speallat
pelkistää	v	njáskat, reduseret
pelkkä	a	dušše
pelottaa	v	baldit
pelätä	v	ballat
perehtyä	v	beassat sisa
perimmäinen	a	maŋimuš
perimätieto	n	árbediehtu
perinnöllinen	a	árbejuvvon
periytyä	v	árbašuvvat
periä	v	árbet
persoonallinen	a	persovnnalaš
perua	v	šluhttet
peruskorjata	v	vuođđodivvut
perustaa	v	vuođđudit
perustaja	n	vuođđudeaddji
peruste	n	ágga
perustella	v	ákkastallat
perustua	v	vuođđuduvvat
perustus	n	vuođđu
perustuslaillinen	a	vuođđolágalaš
peruuttaa	v	murddihit
perä	n	maŋŋegeahči
peräisin	po	eret
peräkkäinen	a	maŋŋálas
perääntyä	v	murdit
pettymys	n	beahttašupmi
pettyä	v	behttot, beahttašuvvat
peukaloida	v	duohtadit
pianisti	n	pianista
pidellä	v	doaladit
pidetä	v	guhkkut
pidättäytyä	v	čuoldásit
pidättää	v	doalahit
pienehkö	a	oalle uhcci
pieni	a	unni
pieniä	v	smávvet
pierrä	v	buoskut
piillä	v	čiehkádallat
piinata	v	biinnidit
piiri	n	bire
piirre	n	sárggus
piirtää	v	sárgut
pila	a	hilbošeapmi
pilkkoa	v	smoarrut
pinta	n	aláš
pisin	a	guhkimus
pitkulainen	a	guhkedáleš
pitkä	a	guhkki
pitkäaikainen	a	guhkesáigásaš
pitkäikäinen	a	guhkesagat
pitkänomainen	a	guhkedáleš
pitäytyä	v	doallánit
pitää	v	doallat, atnit
planeetta	n	planehta
pohja	n	bodni
pohjoinen	n	davvi
pohjoisosa	n	davvioassi
pohjoispuoli	n	davábealle
poika	n	bárdni, gánda
poiketa	v	spiehkastit
poikia	v	čivgat
poikittainen	a	doaris
poikkeava	a	eahpedábálaš
poikkeuksellinen	a	spiehkastat
poikkeus	n	spiehkastat
poistaa	v	jávkadit
poistua	v	geassádit
polkea	v	duolbmat
polttaa	v	boaldit
polveutua	v	nállašuvvat
pommi	n	bomba
pommittaa	v	bombet
pommitus	n	bomben
pomo	a	šefa
pormestari	n	bormeašttir
portti	n	poarta, uksa
potea	v	buohcat
potkaista	v	čievččastit
presidentti	n	presideanta
profiloida	v	profileret
protestanttinen	a	protestánttalaš
provinssi	n	provinsa
psykiatrinen	a	psykiátralaš
psykologi	n	psykologa
psykologia	n	psykologiija
psykologinen	a	psykologalaš
pudota	v	gahččat
pudottaa	v	gahčalit
puhdistaa	v	buhtistit
puhe	n	hupman, hállan, sáhka
puhekieli	n	hállangiella
puhemies	n	soagŋoolmmái
puhjeta	v	ráigánit
puhua	v	hupmat, hállat, sárdnut
puhuttaa	v	humahit
puida	v	vuohttut
puinen	a	muorra-
puisto	n	párka
pukeutua	v	gárvodit
puku	n	dreassa
punaruskea	a	ruškat
punertaa	v	loktet
punertava	a	rukseslágan
puoleinen	a	-beale
puolesta	po	beale
puoli	a	bealli
puoli	n	bealli
puoliväli	n	beallemuddu
puoltaa	v	bealuštit
puolustaa	v	bealuštit
purkaa	v	boltut
purkaus	n	russun
purra	v	gáskit
putki	n	bohcci
puu	n	muorra
puukottaa	v	čugget niibbiin
puutarha	n	šaddogárdi
puutteellinen	a	váilevaš
puuttua	v	váilut
pyhittää	v	basuhit
pyrkimys	n	viggamuš
pysty	a	ceakkus
pystysuora	a	ceakko-
pystyvä	a	ábas
pystyä	v	bastit
pysytellä	v	orrut
pysyä	v	bissut
pysähtyä	v	bisánit
pyydystää	v	bivdit
pyörittää	v	jorahit
pyöriä	v	jorrat
pyörähtää	v	jorralit
päihittää	v	vuoitit
päin	po	guvlui
päinvastainen	a	jorggu-
päivä	n	beaivi
päivämäärä	n	beaivemearri
päiväntasaaja	n	ekváhtor
päivätä	v	beivet
päteä	v	gustot
pää	n	oaivi
pääasiallinen	a	váldo-
päähenkilö	n	váldoolmmoš
pääjohtaja	n	oaivehoavda
pääkaupunki	n	oaivegávpot
päällikkö	n	hoavda
päällystää	v	gokčat, bajidit
päämaja	n	oaivegoartil
pääosa	n	váldooassi
päässä	po	geahččen
pääte	n	(gramm.) geažus, (tietokone) terminála
päätellä	v	árvvoštallat
päätoiminen	a	ollesáigásaš
päättyä	v	nohkat
päättää	v	mearridit
raahata	v	rundit, geassit
raaka	a	roavis
raaka	n	fádda
raaka-aine	n	ávnnas
raamattu	n	biibbal
radikaali	a	radikála
radio	n	rádio
radioaktiivinen	a	rádioaktiiva
rahoittaa	v	ruhtadit
raiskata	v	illastit, ráisket
raivata	v	njáskat
raivostua	v	moaráhuvvat
raivota	v	mielahuddat
rajata	v	ráddjet
rajoittaa	v	ráddjet
rajoittua	v	rádjašuvvat
raju	a	alvvus
rakastaa	v	ráhkistit
rakastettu	a	ráhkis
rakastua	v	ráhkistuvvat
rakennus	n	huksehus
rakennustyö	n	huksenbargu
rakennuttaa	v	huksehit
rakentaa	v	hukset
rakentava	a	huksejeaddji, konstruktiiva
rakenteellinen	a	ráhkaduslaš
raketti	n	rakeahtta
rangaista	v	ráŋggáštit
rangaistava	a	ráŋggáštusvuloš
rankka	a	lossat
rapista	v	skoahpat
rapistua	v	juokŋat
rappeutua	v	billašuvvat
rasittaa	v	váivvidit
raskas	a	lossat
rasvata	v	vuoidat
rata	n	luodda, vuojáhat
ratkaiseva	a	mearrideaddji
ratkaista	v	rátkit
ratketa	v	rahtasit
ratkoa	v	rátkit, čoavddašit
ratsu	n	riidenheasta
ratto	a	hávskodat
raueta	v	healbat, máhccat
rauha	n	ráfi
rauhansopimus	n	ráfišiehtadus
rauhoittaa	v	ráfohit
raunio	n	bázahusat
rauta	n	ruovdi
rautainen	a	ruovde-
rautatie	n	ruovdegeaidnu
rautatieasema	n	ruovdegeaidnostašuvdna
ravinto	n	biebmu, borramuš
ravita	v	biebmat
reagoida	v	reageret
reaktio	n	reakšuvdna
realistinen	a	realisttalaš
rehevä	a	šattolaš
reilu	a	ávddalaš
reipas	a	arvvot
reitti	n	johtolat
rekisteröidä	v	registreret
renessanssi	n	renesánsa
rengas	a	riekkis
retki	n	mohkki
retkikunta	n	ekspedišuvdna
reunustaa	v	guorrat
revetä	v	rahtasit, gaikánit
riehua	v	bieđđat, rieibmudit
riippua	v	heaŋgát
riippuvainen	a	vuloš, sorjavaš
riitaantua	v	riiddáskit
riittää	v	bistit, juoksut
rikastaa	v	riggudit
rikkoa	v	cuvket, biđget
rikkoutua	v	cuovkanit, billašuvvat
rikos	a	rihkus
rinnakkainen	a	bálddalaš
rinnalla	po	bálddas
rinnalle	po	báldii
rinnalta	po	bálddas
rinne	n	fielti, ceahkki
rinta	n	raddi, čižži
rintama	n	rattuš
riski	n	riska
risteyttää	v	russet
risti	n	ruossa, rista
ristiretki	n	ruossagárga
ristiriita	n	ruossalasvuohta, soahpameahttunvuohta
ristiriitainen	a	ruossalas
ristiä	v	roahkohit
ritari	n	riddár
rohkaista	v	roahkasmahttit
roikkua	v	heaŋgát
roisto	a	rosvu, bigohas
romaaninen	a	románalaš
romahtaa	v	gáhččat
romani	n	romána
romanialainen	a	románialaš
romanttinen	a	románttalaš
romuttaa	v	bilidit, biđget
roomalainen	a	romálaš
roomalaiskatolinen	a	romálaškatolalaš
ruhtinas	n	fursta
ruiskuttaa	v	cirgguhit
runko	n	riggi
runollinen	a	lyrihkalaš
runous	n	dikten, poesiija
runsas	a	valljái
runsaslukuinen	a	valjis
runsastua	v	laskat, lassánit
ruoka	n	biebmu
ruokailla	v	boradit
ruokavalio	n	diehtta
ruokki	n	hálka
ruokkia	v	biebmat
ruutu	n	ruvto
ruveta	v	riepmat, álgit
ryhmittyä	v	juohkásit joavkkuide
ryhtyä	v	riepmat, álgit
rykmentti	n	regimeanta
rynnätä	v	girdit, boalddihit
räjähdys	n	bávkkanas
räjähtää	v	vávkkehit
räjäyttää	v	bávkalit
saada	v	oažžut
saaja	n	oažžu
saakka	po	rádjai
saaminen	n	oažžun
saapua	v	joavdat, boahtit
saaristo	n	sullot, suologuovlu
saartaa	v	birastahttit
saastua	v	nuoskut
saastuttaa	v	nuoskkidit
saatava	n	ruhtaoažžun
saatavilla	po	oažžunsajis
saataville	po	oažžunsadjái
saati	cc	hálakeahttá
saattaa	v	sáhttit
saavuttaa	v	joksat
saavutus	n	olahus, jovssus
sade	n	arvi
sademetsä	n	arvevuovdi
sademäärä	n	arvemearri
sairastua	v	buohccát, skihppát
saksa	n	duiskkagiella
sala	a	suollemas
salakuljettaa	v	suoli fievrridit
salaliitto	a	suollemas lihttu
salaperäinen	a	suollemas
salata	v	čiehkat, beaitit
sallia	v	diktit, mieđihit
salo	n	meahcci, vuovdeguovlu
samainen	a	seamma
samanaikainen	a	ovttaáigásaš
samanarvoinen	a	ovttaárvosaš
samankaltainen	a	seammasullasaš
samankokoinen	a	seammasturrosaš
samanniminen	a	seammanammasaš
samansuuntainen	a	seammaháltásaš
samantapainen	a	seammasullasaš
sammua	v	jáddat, (hitaasti) čáskat
samota	v	vánddardit, jođašit
sanasto	n	sátnerádju
sanoa	v	dadjat, lohkat, cealkit
sanoma	n	sáhka
sarja	n	ráidu
sata	n	čuođi
sataa	v	arvit
satakunta	n	čuohtenáre
satavuotinen	a	čuođijahkásaš
satelliitti	n	satellihta
sattua	v	soaitit, deaivat, (kivusta) bávččagit
seassa	po	seahká, siste
seasta	po	seahká, siste
seikka	n	čuokkis, ášši
seikkailla	v	fearánastit
seikkailu	n	fearán
seinä	n	seaidni
seisoa	v	čuožžut
seisova	a	čuoččo-
sekaantua	v	seahkánit
sekainen	a	seahkalaš
sekava	a	moivvas
sekoittua	v	seahkánit
seksuaalinen	a	seksuálalaš
selittää	v	čilget
selkä	a	sealgi
selkärankainen	a	riggeealli
selostaa	v	muitalit
selvitä	v	čielgat
selviytyä	v	ceavzit, birget
sensuroida	v	sensureret
sentti	n	sente
senttimetri	n	sentimehter
seos	n	seaguhus
seostaa	v	seaguhit
seura	a	searvi
seurakunta	a	searvegoddi
seurata	v	čuovvut
seuraus	n	čuovvumuš
seurustella	v	servvoštallat
seutu	n	guovlu
sieltä	adv	doppe
sietää	v	gierdat
siihenastinen	a	dassáš
siirto	n	sirdin
siirtokunta	n	koloniija
siirtolainen	n	sirdolaš
siirtomaa	n	koloniija
siirtyminen	n	sirdin
siirtyä	v	sirdásat
siirtää	v	sirdit
siisti	a	čorgat
siistiä	v	čorget
siittää	v	sagahit
siitä	v	sahkanit, lassánit
sijaita	v	stellet
sijata	v	láhčit
sijoittaa	v	bidjat
sijoittua	v	gávdnat saji
sileä	a	šallat
silmätä	v	geahčastit
sinertää	v	alihastit
sinetöidä	v	seilet
sinfonia	n	symfoniija
siro	a	šiervi
sisin	a	siskkimuš
sisustaa	v	deavdit, čiŋahit
sisällissota	n	siskkáldas soahti
sisällyttää	v	čáhkadit
sisältyä	v	gullat
sisäpoliittinen	a	sisriikkapolitihkalaš
sisässä	po	siste
sitkeä	a	sitkat
sitoutua	v	čatnasit
sitten	adv	dasto
sivistyä	v	čuvggodit
sivuitse	po	guora
sivullinen	a	vieris
sivuta	v	guoskkahit
sivuuttaa	v	hilgut
sodanaikainen	a	soađiáigásaš
sodanjälkeinen	a	soađemaŋáš
sodankäynti	n	soahtan
soida	v	čuodjat
soikea	a	guhkolaš, ovála
sointua	v	čuodjat oktii
soitella	v	čuojahallat
soittaa	v	čuojahit
soittaja	n	čuojaheaddji
soitto	n	čuojaheapmi
solisti	n	solista
solmia	v	čuolbmat
solu	n	sealla
solua	v	suohčat
soluttautua	v	infiltreret
sopeutua	v	vuogáiduvvat
sopia	v	soabadit
sortaa	v	soardit
sortua	v	roahppánit
sosiaalidemokraatti	n	sosiálademokráhta
sosiaalidemokraattinen	a	sosiálademokráhtalaš
sosialismi	n	sosialisma
sosialistinen	a	sosialisttalaš
sota	n	soahti
sotaisa	a	soahtalaš
sotaretki	n	soahtemohkki
sotatoimi	n	soahtedoaibma
sotia	v	soahtat
sotilaallinen	a	militearalaš
sotilas	n	soalddát
soturi	n	solddát
sovelias	a	vuogas
sovellus	n	heivehus
soveltaa	v	heivehit, guoskadit
soveltua	v	heivet, soahpat
soveltuva	a	heivvolaš
staattinen	a	statihkalaš
stadion	n	stadiona
standardoida	v	standardiseret
suhta	n	mearri
suhteellinen	a	gorálaš
suistua	v	firrot, fierrat
sujua	v	geavvat
sujuva	a	njuovžil
suka	n	čohkun
sukellusvene	n	čázevuolášfanas
sukia	v	čohkut
suku	a	sohka
sukupuutto	n	sohkajápmu
sula	a	suddi
sulaa	v	suddat
sulautua	v	suddat oktii
sulava	a	suddi
suljettu	a	gitta
sulkea	v	giddet
sulkeutua	v	mannat gitta
suo	n	jeaggi
suoda	v	suovvat
suodattaa	v	sillet
suoja	n	njáhcu
suojata	v	suddjet
suojautua	v	suddjet iežas
suojella	v	suodjalit
suomalaisugrilainen	a	suomaugralaš
suomenkielinen	a	suomagielat
suomenruotsalainen	a	suomaruoŧŧelaš
suomentaa	v	jorgalit suomagillii
suomi	a	suopma
suorakulmainen	a	njuolggočiegat
suoranainen	a	njuolgat
suoraviivainen	a	njuolggolinnját
suoritin	n	doaimmár, prosessor
suorittaa	v	čađahit
suoritus	n	čađaheapmi
suorituskyky	n	návccat
suoriutua	v	čielgat, geargat
suosia	v	oidit, favoriseret
suosikki	n	idola, oidot
suosio	n	oidojupmi
suositella	v	neavvut, rávvet
suositeltava	a	duosttáš
suosittaa	v	neavvut, rávvet
suosittu	a	bivnnut
suostua	v	guorrasit, mieđihit
suostutella	v	humahit, sojahit
suotuisa	a	oiddolaš, heivvolaš
supista	v	šurrat, cuhlaidit
supistua	v	gáržut, uhccut
suppea	a	gárži
surkastua	v	sotnat, ástat
surkea	a	surgat
surma	n	jápmu
surmata	v	sorbmet, goddit
suu	n	njálbmi
suudella	v	cummástallat
suunnata	v	dollet, sirdit
suunnistaa	v	dollet, dadjalit
suunnitella	v	plánet, guorahallat
suunnittelija	n	plánejeaddji
suunta	n	guovlu
suuntainen	a	-sullasaš
suuntaus	n	hálti, viggamuš
suuntautua	v	jorgalit, dollet
suure	n	sturrodat
suurehko	a	stuorralágan
suuri	a	stuoris
suutuksissa	adv	suhtus, bosis
suvaita	v	gierdat
symboloida	v	symboliseret
synkkä	a	čáhppat, seavdnjat
synnynnäinen	a	mielriegádan
synnyttää	v	riegádahttit
synteettinen	a	syntehtalaš
synty	n	riegádeapmi
syntyperäinen	a	eami-
syntyä	v	riegádit
syrjiä	v	veallat, vealahit
syrjäinen	a	boaitto-
syrjäyttää	v	duvdit eret
systeemi	n	systema
syttyä	v	buollát, čahkkát
sytyttää	v	bullehit, buolláhit
syvyys	n	čieŋalvuohta
syvä	a	čieŋal
syvällinen	a	vuđolaš
syyte	n	sivahus, stevnnet
syytetty	n	áššáskuhtton
syyttää	v	sivahit
syöksyä	v	gahččat
syöstä	v	firrohit, njeaidit
syöttö	n	boraheapmi
syövyttää	v	borrat, borahit
sähkö	n	elektrisitehta, elrávdnji
sähköinen	a	elektrihkalaš
sähköistää	v	elektrifiseret
säilyttää	v	seailluhit, bisuhit
säilöä	v	seailluhit, konserveret
särkeä	v	cuvket, biđget
särkyä	v	cuovkanit, bieđganit
säteillä	v	suonjardit
säteily	n	suonjardeapmi
sävellys	n	komposišuvdna
säveltäjä	n	komponista
säveltää	v	komponeret
sävy	n	ivdni, suoivva
sävyttää	v	báidnit
säännöllinen	a	njuolggaduslaš
säännöstellä	v	heivehallat
säästyä	v	seastašuvvat
säästää	v	seastit
säätää	v	muddet
taa	adv	duohkái
taajuus	n	dávjodat
taantua	v	maŋos
tahi	cc	dahje
taide	n	dáidda
taidemaalari	n	govvadáiddár
taidokas	a	dáiddolaš
taipua	v	sodjat
taipuvainen	a	soddjil, mieđis
taistella	v	dáistalit
taistelu	n	dáistaleapmi
taitse	po	maŋábeale
taittaa	v	doadjit
taivutella	v	sojahallat
tajuta	v	fihttet, árvidit
taka	n	duohki
takainen	a	-duogáš
takoa	v	dearpat
taktiikka	n	taktihkka
tallentaa	v	vurket
tallettaa	v	vurket
talous	n	ekonomiija, dállodoallu
taloustiede	n	álbmotekonomiija
talvehtia	v	dálvádit
talvi	n	dálvi
tammi	n	eaika
tapa	n	vierru
tapailla	v	deaividit
tapainen	a	-dábán
tapaus	n	dáhpáhus
tappaa	v	goddit, sorbmet
tarjoilla	v	fáladit, fáluhit
tarkastaa	v	dárkkistit
tarkata	v	dárkot, fáktet
tarkka	a	dárkil
tarkkailla	v	dárkot, fáktet
tarkkuus	n	dárkilvuohta
tarkoittaa	v	dárkkuhit, mearkkašit
tarkoituksellinen	a	eaktodáhtolaš
tarkoitus	n	ulbmil
tarttua	v	dohppet
taru	n	suvccas
tasainen	a	duolbbas
tasalla	po	dásis
tasapainoinen	a	dássedettolaš
tasapainottaa	v	bidjat veadjaga
tasata	v	dásset
tasavalta	n	republihkka, dásseváldi
tausta	n	duogáš
tavanomainen	a	dábálaš
tavata	v	deaivat
tavoittaa	v	joksat
tehdä	v	dahkat
tehdä	v	dahkat, ráhkadit
teho	n	vuoibmi
tehota	v	váikkuhit
tehtävä	n	bargu, doaibma
teini-ikäinen	a	nuppelotjahkásaš
tekeminen	n	dahkan, dahkamuš
tekniikka	n	teknihkka
telakka	n	dohkka
televisio	n	televišuvdna
teollinen	a	industriijalaš
teollistua	v	industrialiseret
teologi	n	teologa
teologia	n	teologiija
teologinen	a	teologalaš
teoreettinen	a	teorehtalaš
teoria	n	teoriija
teos	n	duodji, bargu
terä	n	dearri, ávju
teräksinen	a	stálle-
testamentti	n	destamente
testata	v	testet
testi	n	teasta
tiede	n	dieđa
tiedekunta	n	fakultehta, dieđagoddi
tiedemies	n	dieđaolmmái
tiedostaa	v	fuobmát
tiedosto	n	fiila, vuorká
tienata	v	dinet
tienoo	n	guovlu
tietoisuus	n	diđolašvuohta
tietty	a	vissis, diehto-
tietynlainen	a	dihtolágan
tietää	v	diehtit
tiheys	n	deahtisvuohta
tiivistää	v	divttistit
tila	n	sadji
tilaisuus	n	dilálašvuohta
tilanne	n	dilli
tilapäinen	a	gaskaboddasaš
tilastollinen	a	statistihkalaš
tilata	v	diggot
tilavuus	n	daddjásvuohta
tippua	v	goaikut
tiukka	a	čavgat
todellisuus	n	duođalašvuohta
todennäköinen	a	jáhkehahtti
todennäköisyys	n	vuordda
todentaa	v	duođaštit
todeta	v	gávnnahit
todistaa	v	duođaštit
todiste	n	duođaštus
tohtori	n	doavttir
toimia	v	doaibmat
toiminnallinen	a	doaibma-
toiminta	n	doaibma
toimittaa	v	doaimmahit
toimitus	n	doaimmaheapmi
toimitusjohtaja	n	beaivválaš
toinen	a	nubbi
toipua	v	váhkkasit, áhtat
toistaa	v	geardduhit
toistua	v	dáhpáhuvvat
toistuva	a	dávji
toivo	n	doaivu
toivoa	v	sávvat, doaivut
tontti	n	viessosadji
tonttu	a	háldi, stállu
torakka	n	kakkerláhkká
tori	n	toarga
torjua	v	duostut
tosi	a	duohta
tosiasia	n	fakta, duohtaášši
tosiasiallinen	a	duođalaš
toteuttaa	v	ollašuhttit
toteuttaminen	n	ollašupmi
toteutua	v	ollašuvvat
tottua	v	hárjánit
toukka	n	suoksa
traaginen	a	tragihkalaš
tuho	n	jápmu
tuhota	v	duššadit
tuhoutua	v	duššat
tukahduttaa	v	hávkadit, čáskadit
tukea	v	doarjut
tukeutua	v	dorjjodit
tukeva	a	starggas
tuki	n	doarja, duvdda, caggi
tukija	n	doarjaleaddji
tukikohta	n	doarjjabáiki
tukkia	v	buođđut
tuli	n	dolla
tulinen	a	buolli
tulipalo	n	buollin
tuliperäinen	a	vulkánalaš
tulkita	v	dulkot
tulo	n	boahtin
tulokas	n	easkaálgi
tulostaa	v	čálihit
tulvia	v	dulvat
tummaihoinen	a	gámis
tummansininen	a	čohkkesalit
tunkeutua	v	bahkket
tunneli	n	tunnel
tunnelma	n	dovddut, mielladilli
tunnistaa	v	dovdát, earuhit
tunnus	n	dovddaldat
tunnustaa	v	dovddastit
tuntea	v	dovdat
tuntua	v	dovdot
tuntuma	n	oktavuohta, lagašvuohta
tuntuva	a	mearkkašahtti
tuoda	v	buktit
tuoksua	v	haksot
tuolloin	adv	dalle
tuomio	n	duopmu
tuomiokirkko	n	duopmogirku
tuomita	v	dubmet
tuossa	adv	duos
tuosta	adv	duos
tuotanto	n	buvttadeapmi, buvttadus
tuottaa	v	buvttadit
tuottelias	a	produktiiva
tuotto	n	vuoitu
tupakoida	v	duhpáhastit, borgguhit
turha	a	dušši
turkki	n	beaska
turmella	v	bilidit, billistit
turpa	n	njunni
turva	n	dorvu
turvota	v	bohtanit
turvottaa	v	bohttehit
tuska	n	duski
tutka	n	rádár
tutkia	v	dutkat
tutkielma	n	dutkan
tuttava	a	oahpis
tuttu	a	oahpis
tutustua	v	oahpásmit, oahpásmuvvat
tutustuttaa	v	oahpásmuhttit
tuulla	v	bieggat
tykistö	n	artilleriija
tykki	n	kanovdna
tykönä	po	luhtte
tyrehtyä	v	nohkat
tyydyttävä	a	duhtadahtti
tyydyttää	v	duhtadit
tyyli	n	stiila, vuohki
tyypillinen	a	mihtilmas
tyyppi	n	tiipa
tyyppinen	a	-typasaš
tyytyä	v	duhtat
työ	n	bargu
työllistää	v	addit barggu
työläs	a	váivi
työntyä	v	hoigasit
työskennellä	v	bargat
työstää	v	ávdnet
työtön	a	bargguheapme
työväki	n	bargoveahka
tähden	po	dihte
tähdätä	v	siktet
tähti	n	násti
tällöin	adv	dalle
tämänkaltainen	a	dánsullasaš
täten	adv	ná
täydentää	v	dievasmahttit
täysi	a	dievas
täysi-ikäinen	a	dievas agis
täysikasvuinen	a	rávis, dievas
täysimittainen	a	olles mihtus
täyttää	v	deavdit
törkeä	a	roavis
törmätä	v	beaškkehit
uhanalainen	a	áitatvuloš
uhata	v	áitit, uhkidit
uhka	n	áitta, uhkádus
uhkaava	a	uhkideaddji
uhmata	v	nágget vuostá
ulko	a	olgo-
ulkoministeri	n	olgoriikkaministtar
ulkopolitiikka	n	olgoriikkapolitihkka
ulkopuolinen	a	vieris
ulottaa	v	olahit
ulottua	v	ollit
unkarilainen	a	ungárlaš
upea	a	ebmui
upota	v	vuodjut
upottaa	v	vuojuhit
upseeri	n	offiseara
ura	n	gurra, luodda, karrieara
uraauurtava	a	álgojalgejeaddji
urheilija	n	valástalli
useasti	adv	dávjá
uskoa	v	oskut
uskollinen	a	oskkáldas
uskomus	n	jáhkku
uskonnollinen	a	kristtalaš
uskottava	a	jáhkehahtti
uskova	n	osku, kristtalaš, oskkolaš
utelias	a	diehtoáŋgir
uudenlainen	a	ođđalágan
uudistaa	v	ođasmáhttit
uudistua	v	ođasmit, ođasmuvvat
uusi	a	ođas
uusiutua	v	ođasmuvvat, ođasmahtit
uusiutuva	a	ođasmuvvi
vaaka	a	veakta
vaakasuora	a	vealu-
vaakuna	n	vearjogovva
vaalea	a	čuovgat
vaaleanpunainen	a	čuvgesruoksat
vaaleansininen	a	čuvgesalit
vaali	n	válga
vaalia	v	váhttet
vaan	cc	muhto
vaan	cs	muhto
vaarantaa	v	riskeret
vaatia	v	gáibidit
vaativa	a	gáibideaddji
vaellella	v	johtalit
vaeltaa	v	vánddardit
vahingollinen	a	vahátlaš
vahvistaa	v	gievrudit
vahvistua	v	gievrut, nannut
vahvuinen	a	givrosaš
vahvuus	n	gievravuohta
vaieta	v	jaskkodit
vaihde	n	molssa
vaihdella	v	molsašuddat
vaihtaa	v	molsut
vaihteleva	a	molsašuddi
vaihtelu	n	molsašuddan
vaihto	n	molsuheapmi
vaihtoehtoinen	a	molssaevttolaš
vaihtua	v	molsašuvvat
vaikea	a	váttis, váigat
vaikeakulkuinen	a	rámššas
vaikeus	n	váttisvuohta
vaikute	n	váikkuhus
vaikuttaa	v	váikkuhit
vailla	po	váile
vaimentaa	v	hávkadit
vainio	n	bealdu, gieddi
vaino	n	doarrádallan, váidnu
vainota	v	doarrádallat
vaipua	v	luovadit
vaisu	a	láivi
vaivata	v	váivvidit
vaja	n	skadjá
vajaa	a	vádjit
vajota	v	vuodjut
vakaa	a	bissul
vakauttaa	v	stáđásmahttit
vakiinnuttaa	v	stáđásmahttit
vakiintua	v	stáđásmit, stáđásmuvvat
vakinainen	a	fásta
vakituinen	a	fásta
vakuuttaa	v	nannet, dáhkidit
vala	n	válli
valaa	v	leiket
valaista	v	čuovgat
valheellinen	a	boastto-, behtolaš
valikoida	v	válljet
valio	a	vállju
valita	v	válljet
valittaa	v	váidit
valkea	a	čeaskat
valkoihoinen	a	vilgesliikkat
vallankaappaus	n	válderihpan, revolušuvdna
vallankumouksellinen	a	revolutionára
vallata	v	váldit, oamastit
vallita	v	ráđđet
vallitseva	a	ráđđejeaddji
valloittaa	v	váldit, oamastit
valloitus	n	váldin
valmentaja	n	hárjeheaddji
valmistaa	v	ráhkadit, ávnnastit
valmistaja	n	ráhkadeaddji
valmistella	v	válmmastallat
valmistua	v	geargat, válbmanit
valmistus	n	ráhkadeapmi
valoisa	a	čuovgat
valottaa	v	čuvget
valpas	a	fitmat
valta	n	váldi, fápmu
valtaisa	a	áibmadas
valtakunnallinen	a	riikkaviidosaš
valtameri	n	váldomearra
valtatie	n	riikkageaidnu
valtaus	n	váldin
valtava	a	hirbmat
valtio	n	stáhta
valtioneuvosto	n	stáhtaráđđi
valtionpäämies	n	stáhtaoaivámuš
valtuutettu	a	áirras
valtuuttaa	v	fápmudit
valuutta	n	valuhtta
valvoa	v	gohcit, gozihit
valvonta	n	bajilgeahčču
vammainen	a	lámis
vammautua	v	roasmmehuvvat
vangita	v	fáŋget
vanha	a	boaris
vanhentua	v	boarásmit, boarásmuvvat
vanheta	v	boarásmit
vanhin	a	boarráseamos
vankeus	n	fáŋgavuohta
vapa	n	stággu
vapaa	a	friddja
vapaamielinen	a	liberála
vapaamuotoinen	a	friijahápmásaš
vapauttaa	v	beastit, luoitit
vapautua	v	beassat, luomusmuvvat
vara	n	ráđđi
varalla	po	várás
varalle	po	váráš
varapuheenjohtaja	n	várreságadoalli
varassa	po	veagas
varastoida	v	vuorkut
varata	v	várret
varaus	n	eaktu, várrehus
varautua	v	várret
varhainen	a	árrat
varjostaa	v	suoivvanastit
varma	a	sihkar, sihkkar
varmuus	n	sihkarvuohta
varoa	v	váruhit
varsi	n	nađđa
varsinainen	a	aitosaš
varsoa	v	guoddit
varteenotettava	a	deaŧalaš, dehálaš
vartioida	v	fáktet, gozihit
varttaa	v	nađđadit
varttua	v	čálgat, rávásmit
varustaa	v	ráhkkanahttit, rustet
varustautua	v	ráhkkanit
varuste	n	bierggas, rusttet
vasemmanpuoleinen	a	gurut
vasemmisto	n	gurut bealli
vasemmistolainen	a	gurut beale olmmoš
vasen	a	gurut
vasenkätinen	a	gurutgieđat
vasta	a	easka
vasta	n	lastarissegihppu
vastaanottaa	v	vuostáiváldit
vastaanotto	n	vuostáiváldin
vastaavanlainen	a	vástideaddji
vastainen	a	boahttevaš
vastakkainen	a	vuostálas
vastakohta	n	vuostegeahči
vastarinta	n	vuostálastin
vastassa	po	ovddal
vastasyntynyt	a	easkariegádan
vasten	po	njeaiga
vastoin	po	vuostá
vastustaa	v	caggat
vastustaja	n	vuostálasti
vastuullinen	a	ovddasvástáduslaš
vaurio	n	vaháguvvan
vaurioittaa	v	vahágahttit
vaurioitua	v	vaháguvvat
vedenalainen	a	čázevuloš
vedota	v	appelleret
veikko	n	bánne
veistää	v	fearrat, belket
velho	n	noaidi
velvoittaa	v	geatnegahttit
velvollinen	a	geatnegas
venyä	v	fatnat
venäläinen	a	ruošša
verbi	n	vearba
verhota	v	gokčat
verinen	a	varrái
veroinen	a	veardásaš
verottaa	v	vearuhit
verrannollinen	a	veardideames
verrata	v	veardidit
versio	n	veršuvdna
versoa	v	bohciidit, ihtit
vertaus	a	veardádus
vertauskuvallinen	a	allegoriijalaš
vesi	a	čáhci
veturi	n	lokomotiiva
vetäytyä	v	geassásit, geassádit
vetää	v	geassit, njaldit
viedä	v	doalvut
viehättää	v	geasuhit
vienti	n	doalvun
vieraantua	v	eaidit, vierrut
vierailu	n	galledeapmi
viereinen	a	mii lea bálddas
vieriä	v	fierrat, jorrat
viesti	n	dieđáhus, sáhka
vietellä	v	fillet, (pahaan) doalvvuhit
vietto	a	atnin, doallan
viettää	v	atnit, doallat
viha	n	fašši, suhttu
vihertävä	a	ruonálágan
vihertää	v	ruodnát
vihkiä	v	vihahit, náitit
viihdyttää	v	hávskkuhit
viikinki	n	vikiŋga
viikoittainen	a	vahkkosaš
viilentää	v	čoaskudit
viilettää	v	šuvgalit
viiletä	v	čoaskut
viiltää	v	(haava) nádjat, (nahasta) vadjat
viimeinen	a	maŋimus
viimeistellä	v	vátnat
viini	n	viidni, viidna
viisinkertainen	a	viđageardásaš
viisivuotias	a	viđajahkásaš
viitata	v	seavvit, čujuhit
viitta	n	gákti, luhkka
viittaus	n	seavvin, čujuheapmi
vilja	n	gordni
viljava	a	šattolaš
viljellä	v	šaddadit, gilvit
viljely	n	šaddadeapmi, gilvin
vilkas	a	ealas
vilkkua	v	livkit, (valosta) libaidit
virallinen	a	virggálaš
virheellinen	a	boasttu-
virittää	v	(jousi) gealdit, (raudat) caggat
virkamies	n	virgeolmmoš
virolainen	a	esttelaš
virrata	v	golgat
virtaus	n	rávdnji, golgan
virtsata	v	gožžat, cissat
virus	n	virus
vitsailla	v	leikošit
voi	n	vuodja
voida	v	sáhttit
voima	n	fápmu
voimakkuus	n	givrodat
voimalaitos	n	fápmorusttet
voimistaa	v	gievrudit
voimistua	v	gievrut
voittaa	v	vuoitit
voittoisa	a	vuoitil
vokaali	n	vokála
vouti	a	váldi
vulkaaninen	a	vulkánalaš
vuolla	v	vuollat
vuorinen	a	gáisái
vuoristo	n	várit
vuoro	n	vuorru
vuorotella	v	lonohallat vuoruid
vuorovaikutus	n	vuorrováikkuhus
vuosi	n	jahki
vuosittainen	a	jahkásaš
vuosituhat	n	duhátjahki
vuotuinen	a	jahkásaš
vyöryä	v	fierrat
väestö	n	álbmot, populašuvdna
vähenevä	a	nohkki
vähentyä	v	geahppánit
vähentää	v	geahppánit, uhccut
vähä	a	unnánaš
vähäinen	a	unni, uhcci
väistyä	v	čáhkket, (taaksepäin) murdit
väitellä	v	nákkáhallat
väittää	v	nágget, čuoččuhit
väitöskirja	n	nákkosgirji
väkevä	a	fámolaš
väki	n	veahka
väkiluku	n	olmmošlohku
väkivaltainen	a	veahkaválddálaš
väli	n	gaska
väline	n	gaskoapmi
välinen	n	-gaskasaš
välitse	po	gaskal
välittää	v	beroštit, fuollat, (riidassa) soabahit, (siirtää) sirdit
välitys	n	sirdin
välitön	a	njuolgat
välttyä	v	beassat, vealtat
välttämätön	a	vealtameahttun
välttää	v	garvit
värillinen	a	ivdnái
värinen	a	-ivdnásaš
värvätä	v	bestet, bálkáhit
värähdellä	v	sparkit
väylä	n	fávli
väärentää	v	botnjat
vääristyä	v	botnjasit
ydin	n	ađa, váimmus
ydinase	n	váimmusvearju
yhdenmukainen	a	ovttalágán
yhdensuuntainen	a	seammaguvllot
yhdiste	n	ovttastus
yhdistelmä	n	oktiibiddju, kombinašuvdna
yhdistys	n	searvi
yhdistyä	v	ovttastuvvat
yhdistää	v	ovttastahttit
yhdyskunta	n	ovttastupmi
yhteenlaskettu	a	oktiiluiton
yhteensopiva	a	oktiiheivvolaš
yhteisö	n	organisašuvdna
yhtenäinen	a	oktilaš
yhtenäistää	v	dahkat oktilažžan
yhtiö	n	fitnodatsearvi
yhtye	n	musiikkajoavku
yhtyä	v	ovttastuvvat
yhtäläinen	a	ovttalágán
yksilö	n	indiviida
yksilöidä	v	spesifiseret
yksimielinen	a	ovttamielalaš
yksimoottorinen	a	ovttamohtor-
yksipuolinen	a	ovttabealat
yksiselitteinen	a	ovttačilggolaš
yksityiselämä	n	priváhtaeallin
yksityiskohta	n	detálja
yksityistää	v	privatiseret
yksivärinen	a	ovttaivnnálaš
yleinen	a	dábálaš
yleismaailmallinen	a	oppamáilmmálaš
yleisradio	n	oktasašrádio
yleistyä	v	lassánit
yleistää	v	generaliseret
yleisurheilu	n	bođuvalástallan
yleisö	n	publikumma
ylellinen	a	luksus-
ylentää	v	alidit
ylettää	v	olahit
yletä	v	allánit
yli	a	badjel
yliluonnollinen	a	badjellunddolaš
ylimääräinen	a	badjelmearálaš
ylioppilas	n	studeanta
ylioppilaskunta	n	studeantagoddi
ylipäällikkö	n	bajimus hoavda
ylistää	v	rámidit
ylittää	v	mannat badjel
ylivoimainen	a	birgetmeahttun
ylle	po	badjelii
yllyttää	v	giktalit
yllättää	v	heahkastuhttit
yltä	po	bajil
yltää	v	ollit
ylä	a	badje-
yläpuoli	n	bajábealli
ymmärtää	v	ipmirdit, áddet
ympärille	po	birra
ympärivuotinen	a	birrajagáš
ympäröidä	v	birastahttit
ynnä	cc	ja, sihke
yrittäjä	n	fitnodatolmmoš
yrittää	v	geahččalit, iskat
ystävystyä	v	šaddat ustibin
äkillinen	a	fáhkka
älykäs	a	fihtolaš, intelligeanta
älyllinen	a	intellektuála
ärsyttävä	a	givssálaš
ärsyttää	v	hárdit, eardudit
ääni	a	jietna
ääninen	a	-jietnasaš
äänioikeutettu	a	jietnavuoigadahtton
äänittää	v	báddet
äänne	n	jietnadat
ääntää	v	jietnadit
ääretön	a	ravdameahttun
ääri	a	rádji, ravda
äärimmäinen	a	ravddamuš
äärioikeistolainen	a	olgešekstremista
öljytä	v	oljet

